----------------------------------
-                                -
-                                -
----                     --     --
-            --                  -
-                                -
-                                -
-                                -
--                   ----        -
-                                -
--                               -
-                                -
-                            --- -
-                                -
-                                -
-      ---                       -
-                                -
-   --------        ----         -
-                                -
-                         -      -
-                            --  -
-                                -
-                                -
---------------              --  -
-                                -
-                                -
----------------------------------
