----------------------------------
-          o                  p  -
-                                -
----    *          --     *    --
-            --           *     -
-                                -
-                       *        -
-                                -
--         *      ----        *  -
-                                -
--              *               *-
-                                -
-                       *    --- -
-                                -
-      *                         -
-      ---              *        -
-                                -
-   --------        ----         -
-                         *     -
-                         -      -
-                       *  -- * -
-                                -
-              *                 -
---------------              --  -
-            o                   -
-                       *        -
----------------------------------